#####
#S# #
#X# #
#XXE#
#####
