#####
#SXX#
# #X#
# #X#
# #E#
#####
